|--------|
|...|..-a|
|..-|.@.b|
|......-c|
|-------d|
