|----------------------|
|..........F...........|
|............////......|
|.........@............|
|......................|
|..........////........|
|...................///|
|............F.........|
|.....//...............|
|----------------------|
