|---------------|
|...|.........-a|
|..-|.@........b|
|.............-c|
|--------------d|
