|---------------|
|...|......F..-a|
|..-|.@........b|
|..........F..-c|
|--------------d|
