|--------|xx
|...|..-a|xx
|..-|.@.b|xx
|......-c|xx
|-------d|xx






