|----------------------|
|..........F...........|
|............////......|
|.........@............|
|......................|
|..........////........|
|.....*...........////.|
|............F.........|
|.....//...............|
|----------------------|
